NO ./textures/brick.xpm
SO ./textures/eagle.xpm
WE ./textures/stone.xpm
EA ./textures/wood.xpm
F 100,50,25
C 135,206,250

11111111111111111111111111111
10000000000000000000000000001
10100100000000000000001010001
10100100000000000000001010001
10100111111100111111111010001
10100000000100100000000010001
10111111110100101111111110001
10000000000100100000000000001
11111111110100101111111111111
10000000000100100000000000001
10111111111100111111111111001
10000000000000000000000000001
10111111111111111111111111001
10000000000000000000000000001
10111111111111111111111111001
10000000000000000000000000001
11111111111111111111111111011
10000000000000000000000000001
10111111111111111111111111001
10000000000000000000000000001
10111111111111111111111110001
100000000S0000000000000000001
11111111111111111111111111111