NO ./textures/brick.xpm
SO ./textures/eagle.xpm


WE ./textures/stone.xpm
EA ./textures/wood.xpm

F 200,100,50

C 100,200,250


11111111111111111
10000000000000001
10111111111111101
10100000000000101
10101111111110101
10101000000010101
10101011111010101
10101010S01010101
10101010101010101
10101000100010101
10101111111110101
10100000000000101
10111111111111101
10000000000000001
11111111111111111