NO ./textures/brick.xpm
SO ./textures/eagle.xpm
WE ./textures/stone.xpm
EA ./textures/wood.xpm
F 50,50,50
C 200,200,200

        11111111111111111
        10000000000000001
        10111111111111101
        10100000000000101
111111111010111111111101111111
100000000010100000000101000001
101111111110101111110101111101
100000000000101000010100000001
111111111111101010010111111111
            10101001000000001
            10101001011111101
            10101001010000101
            10101111010110101
            10100000010000101
            10111111111111101
            10000000000000101
            11111110111111101
                 10100000001
                 10101111101
                 10100000101
                 10111110101
                 10000010101
                 11111010101
                 10001010101
                 10101010101
                 10101010101
                 10101010101
                 10001010001
                 11111011111
                 100000E0001
                 11111111111