NO ./textures/brick.xpm
SO ./textures/eagle.xpm
WE ./textures/stone.xpm
EA ./textures/wood.xpm
F 45,45,45
C 180,180,180

111111111111111111111111111111111111111111111111111
100000000010001000001000100000000010000000000000001
101111111010101011101010101111111010111111111111101
101000001010101010001010100000001010000000000000101
101011101010101010111010111111101011111111111110101
101010001010101010100010000000101000000000000010101
101010111010101010101111111110101111111111111010101
101010000010101010100000000010100000000000001010101
101011111110101010111111111010111111111111101010101
101000000000101010000000001010000000000000101010101
101111111111101011111111101011111111111110101010101
100000000000001000000000101000000000000010101010101
111111111111111111111111101111111111111010101010101
100000000000000000000000100000000000001010101010101
101111111111111111111110111111111111101010101010101
101000000000000000000010000000000000101010101010101
101011111111111111111010111111111110101010101010101
101010000000000000001010000000000010101010101010101
101010111111111111101011111111111010101010101010101
101010100000000000101000000000001010101010101010101
101010101111111110101111111111101010101010101010101
101010101000000010100000000000101010101010101010101
101010101011111010111111111110101010101010101010101
101010101010001010000000000010101010101010101010101
101010101010101011111111111010101010101010101010101
101010101010101000000000001010101010101010101010101
101010101010101111111111101010101010101010101010101
101010101010100000000000101010101010101010101010101
101010101010111111111110101010101010101010101010101
101010101010000000000010101010101010101010101010101
101010101011111111111010101010101010101010101010101
101010101000000000001010101010101010101010101010101
101010101111111111101010101010101010101010101010101
101010100000000000101010101010101010101010101010101
101010111111111110101010101010101010101010101010101
101010000000000010101010101010101010101010101010101
101011111111111010101010101010101010101010101010101
101000000000001010101010101010101010101010101010101
101111111111101010101010101010101010101010101010101
100000000000101010101010101010101010101010101010101
111111111110101010101010101010101010101010101010101
100000000010101010101010101010101010101010101010101
101111111010101010101010101010101010101010101010101
101000001010101010101010101010101010101010101010101
101011101010101010101010101010101010101010101010101
101010001010101010101010101010101010101010101010101
101010111010101010101010101010101010101010101010101
10101000001010101010101010101010101010101010101E101
101011111110101010101010101010101010101010101010101
100000000000000000000000000000000000000000000000001
111111111111111111111111111111111111111111111111111