NO ./textures/brick.xpm
SO ./textures/eagle.xpm
WE ./textures/stone.xpm
EA ./textures/wood.xpm
F 100,100,100
C 150,150,150

11111111111111111111111111111
10000000000110000000000000001
10110000011100000000000000001
10010000000000000000000000001
11111111101100000111000000001
10000000001100000111011111111
11110111111111011100000010001
11110111111111011101010010001
11000000110101011100000010001
10000000000000001100000010001
10000000000000001101010010001
11000001110101011111011110001
11110111 1110101 10111101N001
11111111 1111111 111111111111