NO textures/eagle.xpm
SO textures/wood.xpm
WE textures/stone.xpm
EA textures/brick.xpm

F 120,120,120
C 200,220,255

11111111
1X000001
10000001
10000001
10001001
10001001
10001001
11111111
